NO img/no.xpm
SO img/so.xpm
WE img/we.xpm
EA img/ea.xpm
F 4,113,39
C 1,198,27

       
11111111111111111111
10000000000000000001
10000000000000000001
100000000N0000000001
11111110000001111111
11111110000001111111
11111110000001111111
11111110000001111111
11111110000001111111
11111110000001111111
11111110000001111111
11111111111111111111
